RRRRR-----------------------------------
RXRR-----------RRRRRRRRRR------------RE-
RRR-R--------------------------------RR-
RR---------RRR---------R----------------
---RR-----------------------------------
------R-R-R-R----------R----------------
-----------------------R----------------
-----------R-RRR-------RR---------------
---------R------------------------------
-----------R------RER---R---------------
-----------RR---------------------------
-----------RRR--------R-R-------------RE
-----------RRRR-R----R----------------RR
---E--------------R-R-----------------RE
----------------R------RRR--------------
--------------R------R------------------
----------------R----R------------------
RR------------R---R--R-------------RRR--
ER--------------R------------------RER--
RR-------------RRR-----------------RRR--
-------------------R--------------------
---------------------R------------------
-------------------R-R------------------
RR-----------------R--------------------
RR----R---R---R-R-R------------------E--
---RR---R---R---------------------------
-----------------RR-----R---------------
---------------RRSR-RRR---R-RR----------